5 5
0 0 0 0 0 
0 0 0 0 0 
0 0 0 0 0 
w 0 w w w 
w s 3 3 t 
