5 5
s 3 w 2 1 
0 3 0 3 2 
5 0 4 3 5 
3 0 5 3 2 
1 1 4 w t 
