5 5
s 1 5 3 0 
0 0 4 4 w 
1 2 4 0 w 
3 0 0 5 4 
2 4 4 2 t 
