5 5
s 2 3 5 5 
w 0 1 3 1 
5 3 3 1 3 
3 0 w 5 1 
w w 5 2 t 
